R 1920 1080
NO ./path_to_the_north_texture
SO ./path_to_the_south_texture
WE ./path_to_the_west_texture
EA ./path_to_the_east_texture
S ./path_to_the_sprite_texture
F 220,100,0
C 225,30,0
1111111111111111111111111
1000000000110000000000001
1011000001110000002000001111111111
1001000000011111000000000000000001111
11111111101     1000001110000000000001
10000000001   0  1111000001110111111111111
1111011111          11100000010001
1111011111111111111101001000111111
1100000011010111111000010001111
10002000000001    1100000010001
100000000000011111101010010001
11000001110101011111011110N0111
11110111  1110101  101111010001
11111111  1111111  111111111111
