R  920 1080
NO ././srcs/wall.xpm
SO ./srcs/wood.xpm
WE ./srcs/stone.xpm
EA ./srcs/brick.xpm
S ./path_to_sprite
F 220,100,0
C 225,30,0

11111111111111111111111111111
10000000001100000000000000001
10110000011100000000000010001
10010000000000000000000010001
10110000011100000000000010001
10000000001100000111011110001
11110111111111011100000010001
11110111111111011101010010001
110000001101111111100000100011111
1000000000001    1001100000010001
100000000000011111101010010001111
11000000110101011111011110001
11110111111101011111011110001
10000000001100000000000000001
10110000011100000000000010001
10010000000000000000000010001
10110000011100000000000010001
10000000001100000111011110001
11110111111111011100000010001
11110111111111011101010010001
11000000110101011100000010001
10000000000000001100000010001
10000000000000001101010010001
11000000110101011111011110001
1111011111110101111101111N001
11111111111111111111111111111
