SO ./textures/blue_wall.xpm
NO ./textures/green_wall.xpm
WE ./textures/red_wall.xpm
EA ./textures/cream_wall.xpm
F 220,100,0
C 225,30,0
R 920 1080

11111111111111111111111111111
10000000000000001111111100001
10000000000000001111111100001
1000000000000000000000000000111
100000000000000000000000000000011
101111111111110000000000000011111
101111111111110000000000000000001
10000000000000N000000000000000001
100010100000000000000000000011111
1000110000000000000000000001
10001110000000111111111111111
10000000000000111111111111111
10000000000000000000000000001
11111111111111111111111111111
