NO ./textures/green_wall.xpm
SO ./textures/blue_wall.xpm
WE ./textures/red_wall.xpm
EA ./textures/cream_wall.xpm
F 0,0,0
C 34, 0, 81

11111111111111111111111111111
10000000000000001111111100001
10000000000000001111111100001
1000000000000000000000000000111
1000000000000000000000000001 101
101111111111110000000000000011111
101111111111110000000000000000001
10000000000000N000000000000000001
100000000000000000000000000011111
10000000000000000000000000001
10000000000000111111111111111
10000000000000111111111111111
10000000000000000000000000001
11111111111111111111111111111


