R  920 1080
NO ./path_to_the_north_texture
SO ./path_to_the_south_texture
WE ./path_to_the_west_texture
EA ./path_to_the_east_texture
S ./path_to_the_sprite_texture
F 220,100,0
C 225,30,0

11111111111111111111111111111
10000000000000011111111000011
10000000000000001111111100001
10000000200000000000000000001
10000000000000000000000000001
101111111111110000000000000011111
101111111111110000000000000000001
100000000000000000000000002000001
1000000000000S0000000000000011111
10000000000000000000000000001
10000020000000111111111111111
10000000000000111111111111111
10000000000000000000000000001
11111111111111111111111111111

